5 10
#_##_###_#
#___#_#_#_
###_#_____
##__##_##_
#_###___##